# lvlwidth 21
# lvlheight 25
# bgcolor 0 0 0
# edgecolor 0 0 255
# fillcolor 0 0 0
# pelletcolor 255 255 255
# fruittype 1

# startleveldata
101 3 131 3 3 2 3 3 3 3 3 3 3 2 3 3 3 3 131 133 131
3 3 131 3 131 2 2 3 3 132 3 3 133 131 2 3 3 3 3 3 3
2 120 3 3 2 2 132 2 3 2 3 3 3 3 133 131 2 3 2 131 2
2 3 2 2 133 131 3 3 3 2 3 3 3 3 3 3 3 3 3 3 3
3 131 2 2 3 3 3 2 3 3 120 3 131 131 3 3 2 3 2 2 2
131 131 132 3 3 131 3 130 3 2 2 3 2 3 131 2 3 3 131 3 132
3 131 3 3 3 3 3 132 3 131 131 132 3 3 2 132 2 3 3 2 3
133 3 2 3 3 2 3 2 3 3 2 3 3 132 130 2 3 3 3 3 131
132 3 132 3 3 3 3 3 3 2 2 3 3 3 131 133 3 3 132 3 131
3 3 3 3 3 3 2 131 3 2 3 2 2 3 3 131 3 133 2 2 3
3 2 2 3 133 3 3 2 2 3 111 2 3 131 3 2 3 3 3 2 131
3 2 3 3 131 133 131 3 2 2 3 2 3 2 3 2 2 132 2 2 2
131 3 132 2 2 2 133 2 2 2 3 2 3 3 3 131 130 2 131 3 3
3 3 2 2 133 132 2 132 3 2 3 3 131 3 3 3 2 3 3 130 132
2 3 3 131 3 3 2 132 111 2 3 3 2 2 2 3 3 3 130 2 3
3 2 2 132 2 3 131 3 3 2 3 2 2 3 3 131 3 2 2 131 3
3 2 3 3 3 2 132 2 3 133 132 2 112 3 3 2 2 3 2 3 132
2 131 3 132 3 2 2 3 3 3 3 3 2 3 3 3 3 131 3 131 3
131 2 131 131 131 3 3 3 131 3 132 3 3 3 3 3 132 2 3 3 2
2 2 2 2 3 133 3 3 3 3 132 3 3 131 3 2 2 131 2 131 2
132 3 3 2 2 3 132 2 2 2 3 3 3 3 130 2 3 3 131 3 133
131 2 3 3 3 3 131 132 3 2 3 132 3 2 131 3 3 133 3 3 3
133 3 3 133 131 133 3 3 3 3 132 3 132 3 3 2 2 3 3 3 2
2 2 3 3 132 3 132 2 3 2 3 3 2 111 2 3 131 3 3 131 131
133 2 3 3 2 3 130 2 3 3 131 131 2 131 3 3 3 3 2 3 3
# endleveldata

# sprites