# lvlwidth 21
# lvlheight 21
# bgcolor 0 0 0
# edgecolor 0 0 255
# fillcolor 0 0 0
# pelletcolor 255 255 255
# fruittype 1
# startleveldata
107 100 133 100 133 100 100 133 112 21 113 21 111 133 100 100 133 100 133 100 108
101 2 110 0 110 0 0 110 2 2 110 2 2 110 0 0 110 0 110 2 101
101 2 2 120 0 0 113 2 2 2 2 2 2 2 113 0 0 120 2 2 101
131 112 2 3 111 100 140 100 133 112 2 111 133 100 140 100 112 3 2 111 132
101 0 113 2 2 2 110 0 110 2 2 2 110 0 110 2 2 2 113 0 101
101 0 110 2 113 2 2 120 2 2 120 2 2 120 2 2 113 2 110 0 101
131 112 2 2 105 112 2 2 2 120 2 120 2 2 2 111 106 2 2 111 132
101 2 2 113 0 0 111 112 2 2 2 2 2 111 112 0 0 113 2 2 101
110 2 111 106 0 113 2 0 0 0 13 0 0 0 2 113 0 105 112 2 110
20 2 2 2 111 106 2 0 107 112 1 111 108 0 2 105 112 2 2 2 20
111 112 2 2 2 2 2 0 101 10 11 12 101 0 2 2 2 2 2 111 112
20 2 2 2 111 108 2 0 105 100 100 100 106 0 2 107 112 2 2 2 20
113 2 111 108 0 110 2 0 0 0 4 0 0 0 2 110 0 107 112 2 113
101 2 2 110 0 0 111 112 2 2 2 2 2 111 112 0 0 110 2 2 101
131 112 2 2 107 112 2 2 2 120 2 120 2 2 2 111 108 2 2 111 132
101 0 113 2 110 2 2 120 2 2 120 2 2 120 2 2 110 2 113 0 101
101 0 110 2 2 2 113 0 113 2 2 2 113 0 113 2 2 2 110 0 101
131 112 2 3 111 100 140 100 130 112 2 111 130 100 140 100 112 3 2 111 132
101 2 2 120 0 0 110 2 2 2 2 2 2 2 110 0 0 120 2 2 101
101 2 113 0 113 0 0 113 2 2 113 2 2 113 0 0 113 0 113 2 101
105 100 130 100 130 100 100 130 112 21 110 21 111 130 100 100 130 100 130 100 106
# endleveldata

# sprites