# lvlwidth 11
# lvlheight 11
# bgcolor 0 0 0
# edgecolor 0 0 255
# fillcolor 0 0 0
# pelletcolor 255 255 255
# fruittype 1
# startleveldata
100 100 100 100 132 100 100 100 100 132 106
100 0 120 2 107 2 10 2 2 106 108
107 0 2 2 3 2 2 2 2 130 108
100 2 12 111 2 2 2 2 2 113 140
100 2 2 1 2 2 2 2 2 105 107
100 2 120 2 2 2 2 2 120 100 133
100 2 2 2 2 2 2 2 111 0 110
100 2 2 2 2 2 2 2 110 132 100
113 2 2 2 2 2 2 2 108 11 111
113 2 2 131 2 2 2 4 105 13 111
130 100 100 132 100 100 100 100 106 113 140
# endleveldata

# sprites