# lvlwidth 11
# lvlheight 11
# bgcolor 0 0 0
# edgecolor 0 0 255
# fillcolor 0 0 0
# pelletcolor 255 255 255
# fruittype 1
# startleveldata
112 101 105 110 113 140 140 101 106 101 133
131 0 133 120 105 113 3 1 3 4 132
132 133 112 0 112 0 106 2 101 3 140
106 0 100 120 0 0 133 2 2 120 101
101 100 113 107 101 120 2 3 3 140 106
110 100 100 3 2 12 3 120 2 2 140
140 133 2 2 2 3 2 3 3 2 105
120 0 140 2 3 2 11 107 3 133 108
120 107 108 106 101 140 100 10 3 2 110
131 132 0 0 133 3 3 13 2 2 108
106 140 120 140 113 120 120 120 107 140 132
# endleveldata

# sprites