# lvlwidth 11
# lvlheight 11
# bgcolor 0 0 0
# edgecolor 0 0 255
# fillcolor 0 0 0
# pelletcolor 255 255 255
# fruittype 1
# startleveldata
132 132 140 108 132 120 101 133 120 113 101
113 0 101 131 120 13 132 0 140 140 101
120 140 0 10 0 12 0 2 113 120 113
120 0 107 131 2 2 140 3 0 140 132
106 107 140 0 140 2 2 112 11 0 133
113 108 105 110 0 120 140 101 140 0 120
111 0 107 112 120 0 101 1 0 2 140
133 0 0 0 113 0 120 0 133 111 132
140 0 0 120 140 113 133 0 3 2 106
131 0 105 0 120 100 120 100 2 4 133
140 140 120 130 108 133 132 133 140 113 131
# endleveldata

# sprites