# lvlwidth 21
# lvlheight 25
# bgcolor 0 0 0
# edgecolor 0 0 255
# fillcolor 0 0 0
# pelletcolor 255 255 255
# fruittype 1

# startleveldata
1 3 3 3 3 3 2 132 140 3 2 130 140 2 3 3 3 3 2 3 106
3 2 3 132 140 2 2 3 131 3 3 3 3 140 2 3 3 2 3 3 21
140 132 3 140 2 140 3 3 3 3 131 140 3 140 140 140 140 3 3 131 20
2 3 3 140 2 2 3 3 3 3 3 3 131 3 131 3 3 3 3 2 105
3 3 3 140 3 3 3 3 3 3 3 2 2 3 140 3 131 3 3 2 100
3 3 3 2 131 3 132 140 140 3 131 3 140 2 3 140 2 2 3 3 20
2 2 140 140 3 3 140 131 3 131 2 3 140 3 131 140 3 131 3 3 101
2 140 2 3 3 2 2 3 2 140 140 3 3 2 2 3 3 3 131 131 21
2 3 3 3 3 140 2 3 3 140 3 3 131 3 3 140 2 3 3 2 101
3 3 3 3 140 3 140 3 3 2 2 2 2 3 133 2 3 131 3 3 101
3 131 3 2 140 3 3 2 2 3 10 131 2 3 2 3 3 3 3 132 20
3 2 140 3 3 2 3 3 2 3 2 3 140 140 2 2 3 140 140 3 21
2 3 3 3 112 3 3 140 3 11 130 140 3 2 2 140 2 2 3 3 100
3 2 3 3 3 2 3 2 3 12 3 2 2 2 140 120 140 2 131 3 20
131 132 2 3 3 140 2 2 2 13 3 140 140 3 3 3 2 140 2 140 112
140 140 3 3 3 3 140 140 2 3 3 3 3 3 2 140 3 3 3 3 106
2 3 131 2 2 3 120 3 3 3 4 131 3 3 2 2 2 131 3 3 101
3 3 140 2 3 2 3 3 2 3 3 3 3 3 3 3 3 132 2 131 21
2 2 132 3 3 3 2 132 3 3 131 3 3 140 2 133 3 3 133 3 21
3 2 2 3 2 2 3 3 3 3 3 131 3 3 3 132 140 2 140 3 106
131 3 140 2 140 3 3 2 2 2 3 3 2 2 3 3 131 2 2 140 20
3 3 2 132 3 3 3 2 3 3 131 3 3 132 3 3 3 3 2 3 21
140 2 133 3 140 2 3 3 140 2 3 3 2 3 3 2 2 3 140 140 21
140 2 2 3 2 2 131 3 2 3 3 2 2 140 2 3 3 2 3 131 107
2 3 3 3 3 2 3 3 3 140 2 2 3 140 3 3 3 3 2 21 110
# endleveldata

# sprites