# lvlwidth 21
# lvlheight 21
# bgcolor 0 0 0
# edgecolor 0 0 255
# fillcolor 0 0 0
# pelletcolor 255 255 255
# fruittype 1
# startleveldata
107 100 100 100 100 100 100 133 100 133 100 133 100 133 100 100 100 100 100 100 108
101 2 2 2 2 2 2 110 2 101 0 101 2 110 2 2 2 2 2 2 101
101 2 111 100 108 2 2 2 2 105 133 106 2 2 2 2 107 100 112 2 101
101 2 2 2 110 2 113 2 113 0 101 0 113 2 113 2 110 2 2 2 101
101 2 113 3 2 2 101 2 131 100 130 100 132 2 101 2 2 3 113 2 101
101 2 105 133 112 2 101 2 101 0 0 0 101 2 101 2 111 133 106 2 101
131 112 0 110 2 2 110 2 101 0 120 0 101 2 110 2 2 110 0 111 132
101 2 113 2 2 113 2 2 105 112 2 111 106 2 2 113 2 2 113 2 101
101 2 110 2 107 106 2 0 0 0 13 0 0 0 2 105 108 2 110 2 101
101 2 2 2 110 0 113 0 107 112 1 111 108 0 113 0 110 2 2 2 101
131 100 112 2 2 111 132 0 101 10 11 12 101 0 131 112 2 2 111 100 132
101 2 2 2 113 0 110 0 105 100 100 100 106 0 110 0 113 2 2 2 101
101 2 113 2 105 108 2 0 0 0 4 0 0 0 2 107 106 2 113 2 101
101 2 110 2 2 110 2 2 107 112 2 111 108 2 2 110 2 2 110 2 101
131 112 0 113 2 2 113 2 101 0 120 0 101 2 113 2 2 113 0 111 132
101 2 107 130 112 2 101 2 101 0 0 0 101 2 101 2 111 130 108 2 101
101 2 110 3 2 2 101 2 131 100 133 100 132 2 101 2 2 3 110 2 101
101 2 2 2 113 2 110 2 110 0 101 0 110 2 110 2 113 2 2 2 101
101 2 111 100 106 2 2 2 2 107 130 108 2 2 2 2 105 100 112 2 101
101 2 2 2 2 2 2 113 2 101 0 101 2 113 2 2 2 2 2 2 101
105 100 100 100 100 100 100 130 100 130 100 130 100 130 100 100 100 100 100 100 106
# endleveldata

# sprites