# lvlwidth 22
# lvlheight 22
# bgcolor 0 0 0
# edgecolor 0 0 255
# fillcolor 0 0 0
# pelletcolor 255 255 255
# fruittype 1
# startleveldata
120 101 120 101 140 140 130 120 106 120 131 131 120 106 120 130 140 140 101 120 101 120
108 140 2 12 3 3 3 106 105 0 132 132 0 105 106 3 3 3 12 2 140 108
101 2 2 3 3 3 112 0 0 0 0 0 0 0 0 112 3 3 3 2 2 101
120 1 2 3 120 101 120 111 106 0 0 0 0 106 111 120 101 120 3 2 1 120
133 3 3 3 111 0 105 3 3 106 0 0 106 3 3 105 0 111 3 3 3 133
132 106 2 2 3 105 105 3 3 131 0 0 131 3 3 105 105 3 2 2 106 132
100 132 2 2 11 3 13 3 108 0 0 0 0 108 3 13 3 11 2 2 132 100
110 107 3 101 140 3 3 132 0 133 131 131 133 0 132 3 3 140 101 3 107 110
110 107 106 2 3 3 120 131 0 108 0 0 108 0 131 120 3 3 2 106 107 110
112 0 111 3 107 106 3 140 101 2 140 140 2 101 140 3 106 107 3 111 0 112
140 0 112 10 2 2 4 2 2 2 2 2 2 2 2 4 2 2 10 112 0 140
140 0 112 10 2 2 4 2 2 2 2 2 2 2 2 4 2 2 10 112 0 140
112 0 111 3 107 106 3 140 101 2 140 140 2 101 140 3 106 107 3 111 0 112
110 107 106 2 3 3 120 131 0 108 0 0 108 0 131 120 3 3 2 106 107 110
110 107 3 101 140 3 3 132 0 133 131 131 133 0 132 3 3 140 101 3 107 110
100 132 2 2 11 3 13 3 108 0 0 0 0 108 3 13 3 11 2 2 132 100
132 106 2 2 3 105 105 3 3 131 0 0 131 3 3 105 105 3 2 2 106 132
133 3 3 3 111 0 105 3 3 106 0 0 106 3 3 105 0 111 3 3 3 133
120 1 2 3 120 101 120 111 106 0 0 0 0 106 111 120 101 120 3 2 1 120
101 2 2 3 3 3 112 0 0 0 0 0 0 0 0 112 3 3 3 2 2 101
108 140 2 12 3 3 3 106 105 0 132 132 0 105 106 3 3 3 12 2 140 108
120 101 120 101 140 140 130 120 106 120 131 131 120 106 120 130 140 140 101 120 101 120
