# lvlwidth 21
# lvlheight 21
# bgcolor 0 0 0
# edgecolor 0 0 255
# fillcolor 0 0 0
# pelletcolor 255 255 255
# fruittype 1
# startleveldata
140 140 108 101 140 130 120 113 140 107 140 140 107 140 113 120 130 140 101 108 140 140
100 100 3 2 1 2 2 101 131 0 101 101 0 131 101 2 2 1 2 3 100 100
106 110 131 101 3 133 100 132 131 0 107 107 0 131 132 100 133 3 101 131 110 106
120 10 11 2 2 2 3 108 0 0 132 132 0 0 108 3 2 2 2 11 10 120
106 133 13 3 140 2 130 0 0 0 0 0 0 0 0 130 2 140 3 13 133 106
140 0 120 133 2 3 2 120 133 108 0 0 108 133 120 2 3 2 133 120 0 140
140 140 12 3 3 105 140 2 2 3 108 108 3 2 2 140 105 3 3 12 140 140
132 112 3 3 2 2 3 113 2 2 110 110 2 2 113 3 2 2 3 3 112 132
108 2 2 2 132 111 2 2 3 2 111 111 2 3 2 2 111 132 2 2 2 108
111 3 2 133 0 0 120 108 2 2 132 132 2 2 108 120 0 0 133 2 3 111
100 112 4 112 0 140 140 105 3 108 112 112 108 3 105 140 140 0 112 4 112 100
100 112 4 112 0 140 140 105 3 108 112 112 108 3 105 140 140 0 112 4 112 100
111 3 2 133 0 0 120 108 2 2 132 132 2 2 108 120 0 0 133 2 3 111
108 2 2 2 132 111 2 2 3 2 111 111 2 3 2 2 111 132 2 2 2 108
132 112 3 3 2 2 3 113 2 2 110 110 2 2 113 3 2 2 3 3 112 132
140 140 12 3 3 105 140 2 2 3 108 108 3 2 2 140 105 3 3 12 140 140
140 0 120 133 2 3 2 120 133 108 0 0 108 133 120 2 3 2 133 120 0 140
106 133 13 3 140 2 130 0 0 0 0 0 0 0 0 130 2 140 3 13 133 106
120 10 11 2 2 2 3 108 0 0 132 132 0 0 108 3 2 2 2 11 10 120
106 110 131 101 3 133 100 132 131 0 107 107 0 131 132 100 133 3 101 131 110 106
100 100 3 2 1 2 2 101 131 0 101 101 0 131 101 2 2 1 2 3 100 100
140 140 108 101 140 130 120 113 140 107 140 140 107 140 113 120 130 140 101 108 140 140
